[
[1,2,3,4,10,41,10,10,40,100,16,10,10,100],
[5,6,7,8,10,13,10,10,40,100,16,10,10,100],
[1,2,3,4,10,41,10,10,40,100,16,10,10,100],
[1,2,3,4,10,41,10,10,40,100,16,10,10,100],
[1,2,3,4,10,41,10,10,40,100,16,10,10,100],
[1,2,3,4,10,41,10,10,40,100,16,10,10,100],
[1,2,3,4,10,41,10,10,40,100,16,10,10,100],
[1,2,3,4,10,41,10,10,40,100,16,10,10,100],
[100,100,100,100,100,100,100,10,40,100,16,10,10,100],
[100,100,100,100,100,100,100,10,40,100,16,10,10,100],
[100,100,100,100,100,100,100,10,40,100,16,10,10,100],
[100,100,100,100,100,100,100,10,40,100,16,10,10,100],
[100,100,100,100,100,100,100,10,40,100,16,10,10,100]
]